dmm00m00000m000
0000mm0m0m00m0m
m0m0000mmm0mm00
m0mmmmmm0m00m0m
m00000000mm0000
m0m0mmmm0m00mm0
00m0m0mm000m0m0
0mm0m0mm0m0m0m0
000000m00m0m000
m0mmmmm0mmm0m0m
m0m0m00000m0000
m0m0mmm0m0mmmm0
000000m0m000mm0
0mm0m0m00mmmm00
0m00m0mm0000a0m